SSSSSSSSSS
SP..G....S
S..B..R..S
S....S...S
SSSSSSSSSS
