##########
#P..G....#
#..B..D..#
#....R...#
##########
