SSSSSSSSSSSSSSSSSSSSSS
SP...S....G....S.....S
S.S.S.SSS.SSS.S.SSB..S
S...S.....S...S......S
S.B.S.SSS.S.B.S.SSS..S
S...S...G.S...S...R..S
SSS.SSS.S.SSS.S.SS.SSS
S...S...S.....S......S
S.G.S.B.S.SSS.S.B.S..S
S...S...S...S.S..S...S
S.SSS.S.SSS.S.SSS.S.GS
S.....S.....S.....R..S
S....B....G.....B....S
SSSSSSSSSSSSSSSSSSSSSS
